AccountNo;Ccy;PostDate;Remarks;AdditionalDesc;Credit Amount;Debit Amount;Close Balance
1520023412345;IDR;20 March 2024 10:16:19;HHK2403090-1                                                 MCM InhouseTrf  DARI HADJI KALLA Transfer Fee         HHK2403090-199102;HHK2403090-1                                                 MCM InhouseTrf  DARI HADJI KALLA Transfer Fee         HHK2403090-199102;1900000.00;0.00;1900000
1520023412345;IDR;20 March 2024 10:16:22;HHK240300X5                                                  MCM InhouseTrf  DARI HADJI KALLA Transfer Fee         HHK240300X599102;HHK240300X5                                                  MCM InhouseTrf  DARI HADJI KALLA Transfer Fee         HHK240300X599102;1000000.00;0.00;2900000
1520023412345;IDR;20 March 2024 10:16:26;HHK240300X7                                                  MCM InhouseTrf  DARI HADJI KALLA Transfer Fee         HHK240300X799102;HHK240300X7                                                  MCM InhouseTrf  DARI HADJI KALLA Transfer Fee         HHK240300X799102;500000.00;0.00;3400000
1520023412345;IDR;20 March 2024 10:16:50;HHK240300X6                                                  MCM InhouseTrf  DARI HADJI KALLA Transfer Fee         HHK240300X699102;HHK240300X6                                                  MCM InhouseTrf  DARI HADJI KALLA Transfer Fee         HHK240300X699102;459087.07;0.00;3859087.07
1520023412345;IDR;30 March 2024 14:30:36;HHK240300X-8                                                 MCM InhouseTrf  KE HADJI KALLA Transfer Fee         HHK240300X-899102;HHK240300X-8                                                 MCM InhouseTrf  KE HADJI KALLA Transfer Fee         HHK240300X-899102;0.00;1000000.00;2859087.07
1520023412345;IDR;31 March 2024 23:59:00;                                         Biaya Adm 15200;                                         Biaya Adm 15200;0.00;25000.00;2834087.07
