AccountNo;Ccy;PostDate;Remarks;AdditionalDesc;Credit Amount;Debit Amount;Close Balance
1520023412345;IDR;01 April 2024 13:33:44;Marcomm                                                      MCM InhouseTrf  DARI KALLA INTI KARSA Transfer Fee         20240329134486652999102;Marcomm                                                      MCM InhouseTrf  DARI KALLA INTI KARSA Transfer Fee         20240329134486652999102;10208000.00;0.00;13042087.07
1520023412345;IDR;03 April 2024 12:00:14;(KALLA FRIENDS -XEND                                         MCM InhouseTrf  DARI INTI KARSA PERSADA Transfer Fee         20240402151873591199102;(KALLA FRIENDS -XEND                                         MCM InhouseTrf  DARI INTI KARSA PERSADA Transfer Fee         20240402151873591199102;1575000.00;0.00;14617087.07
1520023412345;IDR;04 April 2024 13:35:08;PT. HADJI KALLA HOLD                                         MCM InhouseTrf  DARI INTI KARSA PERSADA Transfer Fee         20240402151673052199102;PT. HADJI KALLA HOLD                                         MCM InhouseTrf  DARI INTI KARSA PERSADA Transfer Fee         20240402151673052199102;157325000.00;0.00;171942087.07
1520023412345;IDR;25 April 2024 06:08:01;PT. HADJI KALLA HOLD                                         MCM InhouseTrf  DARI INTI KARSA PERSADA Transfer Fee         20240424090453228399102;PT. HADJI KALLA HOLD                                         MCM InhouseTrf  DARI INTI KARSA PERSADA Transfer Fee         20240424090453228399102;54350000.00;0.00;226292087.07
1520023412345;IDR;30 April 2024 23:59:00;                                         Biaya Adm 15200;                                         Biaya Adm 15200;0.00;25000.00;226267087.07
1520023412345;IDR;30 April 2024 23:59:00;                                         Bunga 15200;                                         Bunga 15200;136402.37;0.00;226403489.44
1520023412345;IDR;30 April 2024 23:59:00;                                         Pajak 15200;                                         Pajak 15200;0.00;27280.47;226376208.97
